###############
#1   0 0 0 0 2#
# # # # # #0# #
# 0     0  00 #
#0# # #0# # # #
#     0 0    0#
#0### # # # #0#
##00    0 #   #
#0#0#0#0#0# # #
#00#  0##   0 #
# ### #0# #0#0#
#    0   0 E# #
###############