###############
#0 0   0   0  #
# # #0# # # # #
#0   #0 0#   0#
# #0# # # #0# #
#  0   0    0 #
#0# # #0# # #0#
# 0 1     E 0 #
#0###0#0#0###0#
#   0 0 0 0   #
#0#0# #0# #0#0#
#     0   0   #
###############