###############
#1  #0 0#     #
# # # #0#0# # #
#            0#
# # #0# ###0###
#   0  0 0  00#
# #0# #0# # ###
#   #    0 0 0#
# #0# # # #0# #
#     0 0  E00#
# #0#0#0# #0#0#
# 2 0 000 000 #
###############