###############
#1   0 0 0 0  #
# # # # # #0# #
# 0     0  00 #
#0# # #0# # # #
#     0 0    0#
#0### # # # #0#
##00    0 #   #
#0#0#0#0#0# # #
#00#  0##   0 #
# ### #0# #0#0#
# E  0   0 2# #
###############