########################
# 00 00 00 00 00 00 00 #
#         #######    2 #
# 00              E0   #
#     0 0 0          0 #
#  1          ##########
# ###### ###  #        #
#0      0   00 00000000#
# 00 ########### 00 #  #
########################